0000000000000000
0002220000222000
0021112002111200
0232221221222320
0212121112112120
0023211331123200
0002121111212000
0000212332120000
0000023223200000
0000002112000000
0000000220000000
0000000000000000