0000000000000000
0001110000111000
0010001001000100
0100000110000010
0100000000000010
0010000330000100
0001001111001000
0000100000010000
0000010000100000
0000001001000000
0000000110000000
0000000000000000