0011011002202200
0100100120020020
0013331002333200
0001010000202000
0000100000020000
0000000000000000
0022022001101100
0200200210020010
0023332001333100
0002020000101000
0000200000010000
0000000000000000